geoid,name,B19052001,"B19052001, Error",B19052002,"B19052002, Error",B19052003,"B19052003, Error"
16000US3651000,"New York, NY",3191691,6027,2407855,7824,783836,6124
86000US07002,"07002",24784,758,18783,680,6001,595
86000US07008,"07008",8036,470,6358,443,1678,366
86000US07020,"07020",6046,292,5066,322,980,204
86000US07024,"07024",17396,461,12494,444,4902,489
86000US07030,"07030",24983,497,22053,490,2930,401
86000US07036,"07036",15503,399,12734,410,2769,314
86000US07047,"07047",21992,796,17430,716,4562,602
86000US07064,"07064",1283,150,1114,145,169,65
86000US07077,"07077",984,217,865,228,119,57
86000US07086,"07086",6905,335,5844,379,1061,211
86000US07093,"07093",23585,758,19484,680,4101,498
86000US07202,"07202",13284,671,10886,690,2398,398
86000US07206,"07206",8040,570,6349,466,1691,383
86000US07302,"07302",23261,838,20207,721,3054,456
86000US07305,"07305",23147,794,18367,736,4780,556
86000US07310,"07310",6019,391,5418,396,601,172
86000US07311,"07311",301,142,301,142,0,13
86000US07620,"07620",518,69,367,63,151,41
86000US07632,"07632",1906,115,1536,156,370,121
86000US07670,"07670",4670,220,4018,224,652,180
86000US08861,"08861",17576,638,13820,588,3756,532
86000US10001,"10001",13311,688,10113,725,3198,456
86000US10002,"10002",33790,1063,20404,960,13386,1004
86000US10003,"10003",25158,951,20062,963,5096,601
86000US10004,"10004",1822,352,1609,356,213,174
86000US10005,"10005",4649,476,4487,482,162,118
86000US10006,"10006",1811,290,1701,271,110,116
86000US10007,"10007",2940,420,2687,415,253,213
86000US10009,"10009",29356,1180,20120,1146,9236,796
86000US10010,"10010",16499,981,12460,808,4039,866
86000US10011,"10011",28775,1276,21474,1151,7301,960
86000US10012,"10012",12574,700,10065,711,2509,453
86000US10013,"10013",12294,910,9507,801,2787,513
86000US10014,"10014",17139,939,13582,897,3557,501
86000US10016,"10016",29005,1439,22162,1113,6843,893
86000US10017,"10017",9858,859,7560,788,2298,511
86000US10018,"10018",4321,380,3557,367,764,335
86000US10019,"10019",27340,1460,20866,1225,6474,1180
86000US10020,"10020",0,12,0,12,0,12
86000US10021,"10021",22084,1280,16816,1270,5268,758
86000US10022,"10022",17977,1241,14064,1058,3913,628
86000US10023,"10023",33770,1515,24967,1491,8803,977
86000US10024,"10024",28850,1580,22070,1361,6780,960
86000US10025,"10025",40188,1492,27935,1367,12253,1118
86000US10026,"10026",15362,771,11767,671,3595,475
86000US10027,"10027",23835,951,17498,868,6337,633
86000US10028,"10028",24974,1461,19151,1403,5823,892
86000US10029,"10029",31485,1385,19404,939,12081,1196
86000US10030,"10030",12817,760,9568,655,3249,567
86000US10031,"10031",21863,866,16849,824,5014,570
86000US10032,"10032",21814,1150,16538,1128,5276,726
86000US10033,"10033",19689,782,15914,806,3775,400
86000US10034,"10034",15774,637,12441,692,3333,358
86000US10035,"10035",14740,716,8491,574,6249,584
86000US10036,"10036",17437,1131,13349,799,4088,875
86000US10037,"10037",9797,689,6332,553,3465,477
86000US10038,"10038",10800,754,8050,580,2750,583
86000US10039,"10039",11490,686,8562,775,2928,388
86000US10040,"10040",16100,659,12511,682,3589,551
86000US10044,"10044",5047,411,3940,417,1107,289
86000US10065,"10065",15708,929,11931,739,3777,679
86000US10069,"10069",3106,572,2158,440,948,498
86000US10075,"10075",12075,1035,9145,967,2930,688
86000US10103,"10103",0,12,0,12,0,12
86000US10110,"10110",0,12,0,12,0,12
86000US10111,"10111",0,12,0,12,0,12
86000US10112,"10112",0,12,0,12,0,12
86000US10115,"10115",0,12,0,12,0,12
86000US10119,"10119",0,12,0,12,0,12
86000US10128,"10128",29698,1175,22702,1046,6996,882
86000US10152,"10152",0,12,0,12,0,12
86000US10153,"10153",0,12,0,12,0,12
86000US10154,"10154",0,12,0,12,0,12
86000US10162,"10162",622,290,430,177,192,263
86000US10165,"10165",0,12,0,12,0,12
86000US10167,"10167",0,12,0,12,0,12
86000US10168,"10168",0,12,0,12,0,12
86000US10169,"10169",0,12,0,12,0,12
86000US10170,"10170",0,12,0,12,0,12
86000US10171,"10171",0,12,0,12,0,12
86000US10172,"10172",0,12,0,12,0,12
86000US10173,"10173",0,12,0,12,0,12
86000US10174,"10174",0,12,0,12,0,12
86000US10177,"10177",0,12,0,12,0,12
86000US10199,"10199",0,12,0,12,0,12
86000US10271,"10271",0,12,0,12,0,12
86000US10278,"10278",0,12,0,12,0,12
86000US10279,"10279",40,64,40,64,0,12
86000US10280,"10280",4524,644,4137,616,387,131
86000US10282,"10282",2499,428,2162,432,337,137
86000US10301,"10301",14466,709,10204,637,4262,408
86000US10302,"10302",5982,519,4289,420,1693,397
86000US10303,"10303",8490,555,6622,560,1868,358
86000US10304,"10304",14928,823,10502,827,4426,528
86000US10305,"10305",15379,739,11830,768,3549,422
86000US10306,"10306",19704,754,14783,792,4921,474
86000US10307,"10307",5068,312,4048,353,1020,205
86000US10308,"10308",10245,673,7899,689,2346,436
86000US10309,"10309",11750,760,9548,730,2202,402
86000US10310,"10310",8678,457,6394,464,2284,275
86000US10311,"10311",0,12,0,12,0,12
86000US10312,"10312",21107,863,15971,777,5136,533
86000US10314,"10314",31363,1003,23378,901,7985,632
86000US10451,"10451",20229,923,13381,774,6848,684
86000US10452,"10452",27018,1065,18949,1099,8069,883
86000US10453,"10453",27401,1081,19364,1139,8037,758
86000US10454,"10454",13573,669,8500,642,5073,624
86000US10455,"10455",14826,900,10171,863,4655,559
86000US10456,"10456",31449,1498,22100,1189,9349,997
86000US10457,"10457",24333,1098,17192,926,7141,757
86000US10458,"10458",28705,1082,21428,1054,7277,779
86000US10459,"10459",17058,760,11906,650,5152,523
86000US10460,"10460",20212,766,13728,726,6484,581
86000US10461,"10461",19122,723,14545,639,4577,537
86000US10462,"10462",28981,952,23117,990,5864,466
86000US10463,"10463",29490,1121,21191,861,8299,948
86000US10464,"10464",1874,235,1366,249,508,170
86000US10465,"10465",16122,741,11639,775,4483,508
86000US10466,"10466",25009,1032,18664,995,6345,752
86000US10467,"10467",37713,1103,27761,1059,9952,839
86000US10468,"10468",26917,1296,19380,1134,7537,927
86000US10469,"10469",22886,893,17024,883,5862,738
86000US10470,"10470",6096,424,4576,397,1520,280
86000US10471,"10471",8714,475,5845,419,2869,386
86000US10472,"10472",22221,814,15264,770,6957,629
86000US10473,"10473",21940,1078,14469,860,7471,809
86000US10474,"10474",3506,367,2483,410,1023,216
86000US10475,"10475",18653,1081,11853,969,6800,1090
86000US10550,"10550",14488,751,10445,616,4043,624
86000US10704,"10704",11696,622,9030,595,2666,313
86000US10705,"10705",14593,794,10971,820,3622,454
86000US10803,"10803",4044,199,3277,168,767,171
86000US10805,"10805",7990,519,6051,525,1939,348
86000US11001,"11001",8733,434,7128,428,1605,211
86000US11003,"11003",12270,559,10340,545,1930,373
86000US11004,"11004",4808,314,3701,342,1107,194
86000US11005,"11005",1609,457,555,377,1054,301
86000US11020,"11020",1848,215,1626,219,222,70
86000US11021,"11021",7623,284,5710,306,1913,263
86000US11040,"11040",13078,508,10365,482,2713,323
86000US11042,"11042",0,12,0,12,0,12
86000US11096,"11096",2558,265,1865,234,693,198
86000US11101,"11101",14951,938,12676,875,2275,329
86000US11102,"11102",12960,581,10234,553,2726,345
86000US11103,"11103",15575,646,13126,647,2449,290
86000US11104,"11104",11281,504,8982,495,2299,292
86000US11105,"11105",15274,575,12583,536,2691,298
86000US11106,"11106",16975,747,13278,702,3697,524
86000US11109,"11109",2777,378,2686,376,91,58
86000US11201,"11201",29262,817,24237,775,5025,408
86000US11203,"11203",29249,916,22683,988,6566,475
86000US11204,"11204",23520,743,18335,599,5185,446
86000US11205,"11205",16779,767,13181,588,3598,605
86000US11206,"11206",31489,958,23345,985,8144,596
86000US11207,"11207",34010,1096,23041,949,10969,914
86000US11208,"11208",34368,1290,25271,1256,9097,850
86000US11209,"11209",29186,936,22140,734,7046,574
86000US11210,"11210",21851,776,17508,732,4343,563
86000US11211,"11211",40821,1228,34379,1300,6442,599
86000US11212,"11212",31207,1141,18382,996,12825,873
86000US11213,"11213",26377,1048,20007,1194,6370,628
86000US11214,"11214",31717,849,24078,707,7639,518
86000US11215,"11215",28714,1057,24473,1087,4241,438
86000US11216,"11216",25771,935,20466,863,5305,653
86000US11217,"11217",18627,777,15303,719,3324,502
86000US11218,"11218",25219,1012,20493,887,4726,514
86000US11219,"11219",23871,911,19287,887,4584,530
86000US11220,"11220",27849,888,22965,818,4884,453
86000US11221,"11221",33067,1218,25388,1168,7679,706
86000US11222,"11222",17941,795,14556,776,3385,396
86000US11223,"11223",27709,889,20319,838,7390,563
86000US11224,"11224",19272,869,10906,805,8366,694
86000US11225,"11225",24177,921,19479,924,4698,507
86000US11226,"11226",37483,1007,29991,921,7492,534
86000US11228,"11228",15473,576,11790,508,3683,412
86000US11229,"11229",31099,885,22218,838,8881,734
86000US11230,"11230",31254,917,22763,929,8491,683
86000US11231,"11231",15871,750,12659,806,3212,388
86000US11232,"11232",8936,591,7739,605,1197,212
86000US11233,"11233",31811,1176,22932,1148,8879,820
86000US11234,"11234",32227,801,24347,790,7880,578
86000US11235,"11235",32492,984,22088,907,10404,676
86000US11236,"11236",34018,923,26954,865,7064,564
86000US11237,"11237",17383,767,14201,783,3182,406
86000US11238,"11238",25443,952,20565,895,4878,513
86000US11239,"11239",6771,520,3691,530,3080,473
86000US11354,"11354",20115,1038,14246,904,5869,530
86000US11355,"11355",28422,1037,21144,889,7278,700
86000US11356,"11356",7346,497,6178,474,1168,230
86000US11357,"11357",14437,675,10604,642,3833,409
86000US11358,"11358",12923,630,9985,419,2938,462
86000US11359,"11359",0,12,0,12,0,12
86000US11360,"11360",8293,563,5329,518,2964,338
86000US11361,"11361",10659,825,8073,463,2586,704
86000US11362,"11362",7153,539,5299,558,1854,307
86000US11363,"11363",2779,256,2114,280,665,124
86000US11364,"11364",13141,571,9948,556,3193,432
86000US11365,"11365",15702,1019,11826,733,3876,882
86000US11366,"11366",4514,321,3516,305,998,207
86000US11367,"11367",13930,576,10706,585,3224,520
86000US11368,"11368",28163,1041,22838,908,5325,654
86000US11369,"11369",9566,550,7309,480,2257,322
86000US11370,"11370",7550,591,5497,462,2053,377
86000US11371,"11371",0,12,0,12,0,12
86000US11372,"11372",23842,995,18192,879,5650,623
86000US11373,"11373",31255,1127,24646,1057,6609,751
86000US11374,"11374",19044,792,14234,744,4810,464
86000US11375,"11375",32509,1090,24578,949,7931,660
86000US11377,"11377",31601,1020,24489,1058,7112,687
86000US11378,"11378",12887,576,10474,581,2413,287
86000US11379,"11379",13561,639,10557,656,3004,362
86000US11385,"11385",35589,737,29151,741,6438,570
86000US11411,"11411",6183,313,4914,309,1269,154
86000US11412,"11412",11259,478,9223,498,2036,267
86000US11413,"11413",12694,521,10525,511,2169,256
86000US11414,"11414",11058,661,7383,559,3675,508
86000US11415,"11415",7849,399,6138,422,1711,247
86000US11416,"11416",7409,469,6139,431,1270,243
86000US11417,"11417",8887,449,7096,393,1791,285
86000US11418,"11418",11250,685,9283,626,1967,363
86000US11419,"11419",12497,646,10855,598,1642,326
86000US11420,"11420",13042,538,11213,546,1829,283
86000US11421,"11421",11325,551,9675,544,1650,193
86000US11422,"11422",9951,454,8410,480,1541,269
86000US11423,"11423",9838,590,7885,452,1953,417
86000US11424,"11424",0,12,0,12,0,12
86000US11426,"11426",6287,462,4977,397,1310,319
86000US11427,"11427",7745,390,6199,390,1546,286
86000US11428,"11428",6121,585,4841,515,1280,283
86000US11429,"11429",8006,595,6294,442,1712,566
86000US11430,"11430",0,12,0,12,0,12
86000US11432,"11432",18790,744,15156,739,3634,337
86000US11433,"11433",10655,504,8417,525,2238,310
86000US11434,"11434",21510,808,16427,921,5083,564
86000US11435,"11435",19310,1016,15823,867,3487,511
86000US11436,"11436",5496,318,4534,309,962,219
86000US11451,"11451",0,12,0,12,0,12
86000US11509,"11509",742,115,518,108,224,64
86000US11559,"11559",2427,401,1729,256,698,250
86000US11580,"11580",13015,723,11124,688,1891,327
86000US11581,"11581",6908,429,5873,424,1035,184
86000US11691,"11691",21163,951,15615,952,5548,767
86000US11692,"11692",7408,471,5630,435,1778,279
86000US11693,"11693",5210,506,3351,295,1859,438
86000US11694,"11694",8069,368,6052,388,2017,345
86000US11697,"11697",1295,222,840,217,455,124
